FlightGPS	KEYWORD1
UbloxGPS	KEYWORD1
CopernicusGPS	KEYWORD1
init	KEYWORD2
update	KEYWORD2
setAirborne	KEYWORD2
getLat	KEYWORD2
getLon	KEYWORD2
getAlt	KEYWORD2
getHour	KEYWORD2
getMinute	KEYWORD2
getSecond	KEYWORD2
getDay	KEYWORD2
getMonth	KEYWORD2
getYear	KEYWORD2
getSats	KEYWORD2
getFixAge	KEYWORD2
ADAFRUIT_BAUD	LITERAL1
COPERNICUS_BAUD	LITERAL1
UBLOX_BAUD	LITERAL1